111111111111111111111111111111111111111111111111111111111111111111111111111111
1001000000000000000000000000000000000000000000000000000000000000000000000000C1
1100000000011000000000000000000000000000000000000000000000000000000000000000C1
1P0011E100001000000000000000000000000000000000000000000000000000000000000000C1
111111111111111111111111111111111111111111111111111111111111111111111111111111
111111111111111111111111111111111111111111111111111111111111111111111111111111
111111111111111111111111111111111111111111111111111111111111111111111111111111
111111111111111111110001111111111111111111111111111111111111111111111111111111
111111111111111111111111111111111111111111111111111111111111111111111111111111
111111111111111111111111111111111111111111111111111111111111111111111111111111
111111111111111111111111111111100011111111100011111111111111111111111111111111
111111111111111111111111111111111111111111111111111111111111111111111111111111
111111111111111111111111111111111111111111111111111111111111111111111111111111
111111111111111111111111111111111111111111111111111111111111111111111111111111
111111111111111111111111111111111111111111111111111111111111111111111111111111
111111111111111111111111111111111111111111111111111111111111111111111111111111
111111111111111111111111111111111111111111111111111111111111111111111111111111
