111111
1001C1
1E0001
1000P1
111111
