11111111111111111111111111
10C00C10000010111100000101
10111010111E10000001010101
1C00100C100C101C1111010101
111010111011101011110101C1
1P00100C100000101C0001C001
11111111111111111111111111
